1111111111111
1001000000EC1
10P0011111001
100011C100001
1111111111111