1111111111111
1P0C0E000001
1111111111111