1111111111111
1P00E000000C1
1111111111111