1111111111111
1P0C0E00000E1
1111111111111