1111111111
10000000C1
1110111011
1000100001
1C101P1111
10101000C1
1010111011
1000001001
1C111110E1
1111111111