1111111111111111111111111111111111
1P000100C0000000100000000000000001
1110111011101110111011101110111011
1000000000100010001000000000100001
1011111110101111111011111110101111
1000000010100000000010000000100001
1110111010101110111010101110101111
10001000100010001000100010001000C1
1010101110101010101110101010101111
1000100000001000000010000000100001
1011101111111011111011111111101111
1000100000000010001000000000100001
1010111011101110101011101110101111
10100C1000100000100010001000100011
101111101010111111101C101111101011
1000000010001000000010001000000011
1110111010101010111010101011101011
10001000101000100E1000100010001011
1011101110101110111011101110101011
1000000000001000000000001000C00011
1011111111111011111111111011111011
1000000000000000000010000000000001
1C010111010111011101010111010111C1
1000100000001000000010000000100001
1010101111111010101011111110101111
1000001000000010001000000000100001
1110101011101111111010101110101111
1000100010000000100010001000000011
1011101010111110101110101111111011
1C00000000C010000100C0000000000001
1111111111111111111111111111111111